0000000000000000000000000000000000000000000000000000000000000000
0000000000000000000000000000000000000000000000000000000000000000
0000000000000000000000000000000000000000000000000000000000000000
0000000000006666666666666666060660606606606060000000000000000000
0000600000006000000000000000000000000000000006060000000000000000
0000000000006000000000000000000000000000000000006000000000000000
0000600000006000000000000000000000000000000000000600000000000000
0000000000006000000000000000000000000000000000000600000000000000
0000000000006000000000000000000000000000000000000660000000000000
0000600000006000000000000000000000000000000000000060000000000000
0000000000006000000000000000000600000000000000000060000000000000
0000600000006000000000000006606006066000000000000006000000000000
0000600000006000000000000000000000000660000000000000000000000000
0000000000006000000000000060000000000066600000000006000000000000
0000600000060000000000000600000000000000600000000006000000000000
0000000000060000000000006000000000000000600000000000600000000000
0000600000060000000000000000000000000000000000000000000000000000
0000000000006000000000000000000000000000600000000000600000000000
0000600000006000000000060000000000000000600000000000000000000000
0000600000006000000000000000000000000000600000000000000000000000
0000000000006000000000060000000000000000060000000000600000000000
0000600000006000000000600000000000000000000000000000000000000000
0000000000006000000000600000000000000000060000000000000000000000
0000600000006000000000000000000000000000060000000000600000000000
0000600000006000000000060000000000000000000000000000000000000000
0000000000006000000000000000000000000000060000000000600000000000
0000600000006000000000060000000000000000006000000000000000000000
0000600000006000000000060000000000000000000000000000600000000000
0000600000006000000000000000000000000000006000000000000000000000
0000000000006000000000006000000000000000006000000000000000000000
0000600000006000000000006000000000000000006000000000600000000000
0000000000006000000000000600000000600000006000000000000000000000
0000600000006000000000000006600006000000000600000000000000000000
0000000000006000000000000000006660000000000600000000000000000000
0000600000006000000000000000000000000000000000000000000000000000
0000600000006000000000000000000000000000000600000000000000000000
0000000000006000000000000000000000000000006000000000000000000000
0000600000006000000000000000000000000000006000000000006000000000
0000600000006000000000000000000000000000060000000000000000000000
0000600000000600000000000000000000000000660000000000000000000000
0000600000000600000000000000000000000006600000000000000000000000
0000600000000600000000000000000000000066000000000000000000000000
0000600000000066000000000000000000666600000000000000000600000000
0006000000000000660606066066666666000000000000000000000060000000
0006000000000000000000000000000000000000000000000000000600000000
0006000000000000000000000000000000000000000000000000000600000000
0000600000000000000000000000000000000006000000060060660000000000
0000606600000000000000000000000000060666000000000000600000000000
0000000000660000000060006006000060000000000000000000000000000000
0000000000000006000060000000000000000000000000000000000000000000
0000000000000000000000000000000000000000000000000000000000000000
0000000000000000000000000000000000000000000000000000000000000000
0000000000000000000000000000000000000000000000000000000000000000
0000000000000000000000000000000000000000000000000000000000000000
0000000000000000000000000000000000000000000000000000000000000000
0000000000000000000000000000000000000000000000000000000000000000
0000000000000000000000000000000000000000000000000000000000000000
0000000000000000000000000000000000000000000000000000000000000000
0000000000000000000000000000000000000000000000000000000000000000
0000000000000000000000000000000000000000000000000000000000000000
0000000000000000000000000000000000000000000000000000000000000000
0000000000000000000000000000000000000000000000000000000000000000
0000000000000000000000000000000000000000000000000000000000000000
0000000000000000000000000000000000000000000000000000000000000000
